PROCURE NAS LIVRARIAS, DESTA MESMA SERIE DE FICÇÃO CIENTIFICA:
0 FUTURO COMEÇOU	Isaac Asimov
NÓS, OS MARCIANOS	Isaac Asimov
OS ANÉIS DE SATURNO	Isaac Asimov
FUNDAÇÃO (Trilogia)	Isaac Asimov
AS CAVERNAS DE MARTE	Isaac Asimov
OS ROBÔS	Isaac Asimov
0 GRANDE SOL DE MERCÚRIO	Isaac Asimov
DESPERTAR DOS DEUSES	Isaac Asimov
CAÇA AOS ROBÔS	Isaac Asimov
OITO-DOIS-SETE ERA GALÁCTICA	Isaac Asimov
VIGILANTE DAS ESTRELAS	Isaac Asimov
F DE FOGUETE	Ray Bradbury
E DE ESPAÇO	Ray Bradbury
A CIDADE PERDIDA DE MARTE	Ray Bradbury
A HUMANIDADE ARTIFICIAL	Edmund Cooper
CAVALO-MARINHO NO CÉU	Edmund Cooper
ESSAS ESTRELAS SÃO NOSSAS	Poul Anderson
GUERRA DOS HOMENS ALADOS	Poul Anderson
NAVE ESCRAVA	Frederik Pohl
CEI 0 GIGANTE	Curt Siodmak
250 SÉCULOS APÓS...	James Blish
0 TERCEIRO PLANETA	Arthur C. Clarke
BONECA DO DESTINO	Clifford D. Simak
OS HOMENS MOLECULARES	Fred e Geoffrey Hoyle
VÊ NUS MAIS X	Theodore Sturgeon
0 TERROR RETHIANO	Damon Knight
0 DIABÓLICO CÉREBRO ELETRÔNICO	David Gerold
Ou peça pelo reembolso postal C.P. 9686 - S.P.

Torna-se redundante insistir nas qualidades deste famoso escritor norte-americano de ficção-científica; sua consagração já se deu sobejamente, ao receber os prêmios Hugo e Nebula, os dois maiores prêmios conferidos aos autores desta modalidade literária injustamente desprezada. Este livro foi editado, por assim dizer, em sua homenagem, ao ter sido o Convidado de Honra da Boskone XI (convenção de ficção científica da cidade de Boston).
Aqui encontramos mais algumas das já inumeráveis facetas do talento e da verve deste escritor da mais notável fertilidade de raciocínio e originalidade de concepção. Júpiter, o planeta gigante de nosso sistema solar, poderia ser objeto de "venda” ou "arrendamento” a outras criaturas que pouquíssimo teriam em comum com nossa espécie humana, com finalidades ao mesmo tempo, óbvias e desconcertantes?